1111111111111
1P000000000E1
100001L0C0111
1000011111111
100000C0C0C01
1111111111111