111111111111111111111111111111111111111111
1P000000000000000000000C000000000000000001
111100011111111000111111100011111110000001
100000010000000000000000100010000011111101
100011110000011111100000100010000000000001
100010000000010000100000000010011111000001
100010000011110000111111111110011111100001
100010C00010000000000000000000001111110001
111111111100001111111111111100011111100001
100000000000001C00000000000000000000000001
100011111111111100001111111100000001111101
100011111111111100000000001100000001000001
100011111111111100000000001111111111000001
100010001111000100001111111111000000000001
100000000000000000000000000000000000000001
111111111110011111100111111111111110000001
10000000C010011111100010000000000000000001
100000011110011111100011111111111100000001
100000000000011111100000000000000100000001
111111111111111111111000011111000111110001
1CCC10000000000000000000100000000000000001
1CCC100000000000000000000100000000000000E1
111111111111111111111111111111111111111111