1111111111111111
1P00000000000001
111110L111110001
1C00001000000001
1000111111111101
10000000001C0001
11111110L0111101
1000000000000001
1000001111100001
1011110000111111
100000C000000001
10001111111110L1
100010000001C001
1C001000000000E1
100011111100L011
1111111111111111