111111111111111111111111
1P0000000000C00000000001
111100011111111100001101
1C0000000000000000000001
111111100111111111111001
100000000100000000001001
101111111100011111101001
101000000000010000101001
101000011111110000101001
101C0000000000L000101001
101111111111111111101001
100000000000000000001001
100011111111111111101001
1L0000000000000000C00101
100011111111111111111E01
111111111111111111111111