1111111111111111
1P00000000000001
1111100111110001
1C00001000000001
1000111111111101
1000000000000001
1111111000111101
1000000000000001
1000001111100001
1011110000111111
100000C000000001
1000111111110001
100010000001C001
1C001000000000E1
1000111111000001
1111111111111111