1111111111111111111111111111111111111111111111111111
1P00000000000000000000000000000000000000000000000001
11110001111111111110010000011111111111111111111L0L11
1000000000000000000001LCCL11111110CC00000000000000L1
1011111111111111000001111111111111111111111111111111
1000000000000001000000000001000010000000000000000001
1L111111110CCC0100000000011100001111111110000CC00001
1000C0C000000001000000000000000010000000000000000001
1111111111111001001111111111001111111110000000000001
1000000000000001000000000000000000000000000000000001
10C01111111111110L0111111111111000111001111111000001
1000000000000000000000000000000000010000000001000001
10111111111111111111111111111100000LLL00000001111111
1000000000C0C0C0C0C0C0C0C0000L0000000000000000000001
111111111111111111111111111111111111111111111110C001
1000000000000000000000000000000000000000000000000001
1011111111111111111111111111111000000111111111111111
10CC001111111111111111110000000000000000010001000001
101000000000000000000000000000000000000100010000C001
1L11111111111111111111111111111111111111111111110001
10C0000000000000000000000000000000000000000000000001
100L111111111111111111111111111111000000000000000001
1000000000000000000L0000L0000000L0000011111111111111
1011111111L00001L000000000011L0000L000L11000L0000001
1000000000LLL00000011LL0000000000000000L00L00L00CL01
1000000000000001L000000000L1LL00000L11000L1100000001
1011111111111111111111111111111111111111111111111111
100000000000000C0C0C0C0C0C0C0C0C0C0C0C000000000000E1
1111111111111111111111111111111111111111111111111111