11111111111
1P000C00LE1
11111111111