111111
100001
10C0P1
1000E1
111111
